%%%%%%%%
%%  %%%%
%%Pb  %%
%%% % %%
%.% %  %
%.b  % %
%.   b %
%%%%%%%%