%%%%%%
%%  %%
%Pb %%
%%b %%
%% b %
%.b  %
%..B.%
%%%%%%