%%%%%%%
%%%P .%
% b %.%
%  bb %
%.  % %
%   b.%
%%%%%%%